============================================================
=----------------------------------------------------------=
=----------------------------------------------------------=
=--------======--------------------------------------------=
=--------=----=--------------------------------------------=
=--------=----=--------------------------------------------=
=--------======--------------------------------------------=
=------------------1------------===------------------------=
=-------------------------------===------------------------=
=-------------------------------===------------------------=
=----------------------------------------------------------=
=----------------------------------------------------------=
=----------------------------------------------------------=
=----------------------------------------------------------=
============================================================